34
34
110000111100011100011100011111111a1
10000000007470000400000400000048171
1b000000000300000300000300000011191
11100011113331113331113331111001101
11100011111111111111111111111100401
11100011000000000000000000011111101
11100011000000000000000000014001101
11130011000000000000000000011100001
111100110000000000000000000111111A1
11104011000000000000000000411111111
11100011000000000000034000000000001
11100011000000000000011111100303001
11103311000000000003111111100101001
11101111000000000001100000000000031
11140011000000000311000030000003011
11100311000000000110003010030001001
11100111000000001110301000010000001
11130011000000011110100031000031001
111100110000001111100000110000114B1
11103011000001111111111111111111111
11101011000011111111111111111111111
11100011000111111111111111111111111
11100011001111111111111111111111111
11100311010000000000000000000000001
11104111400004000000000000000000001
11100011110001010101003430034000001
11130011111343333330011111111100001
11110011000111111110000000000010001
11104011000000000000033333333001001
11100311000000000000011111111000011
11100111333333000000000000000011111
11100011111111001111111111111400001
11104011000000011111111111111114001
1B000000000011111111111111111111111
11111111111111111111111111111111111