39
39
1911111111111177777771111111111777771111
1000000074747000000000747474700000000041
1111111111111111777111111111111177711111
1000000000000000010000000000000001000001
1Ab0000000000000040000000000000004000dC1
1111100111111111111111110001111111111111
10001174000000001010100000000001100000a1
1400011640000000303030000000000110000401
1113001174000000400040000000000110000001
1111000116400000004000000004000110300301
1111100011740000303030000003000110100101
1111114001111111111111111111100110000001
1111111300000774774770000000000110400001
1111111111111111111111111111110110000001
1000000007474111111111474747000110300301
1011111111111111111111111111000110100101
1000000007474111111111470000000110000001
1011111111111111111111111111310113000001
1000000000000111111111111111110111003001
1111111113430000000000000000000110001001
1111111111111111111111111111110110000001
1000000000004740000000000011114113300001
1011111111111111111100000011110111130001
1011111111111111111110000011110111113001
1411111111111111111111100000000111111001
1011111111111111111111111111111110000001
100000000001111111110000000000e110000031
1111111111011111111100000000040110400311
1000000000011111111100000000403110000101
1000000000011111111100000004031110300001
1000000000011111111100000040310110130001
1000000000011111111100000403100110010001
1000000000011111111100004031000110000401
1000000000011111111100040310000110000031
1000000000011111111100403100000110300311
1000000000011111111104031000000113100101
1111110000011111111100310000000111030001
1111110000011111111103100000000110014001
18cD11D00fE111111111F10000000001100000B1
1111111111111111111111111111111111111110