19
19
10000000000000000000
01000000000000000000
00100000000000000000
00010000000000000000
00001000000000000000
00000000000000000000
00000000000000000008
00004334000000004111
10011111111111111000
01400001111111110000
00100040000400000000
00010011111111000000
00013310000000100000
0001111000000000400a
01400000111111111111
01110000333333331111
41111000000000000709
A1111140000000111111
11111111111100004111
11111111111111111111